1111111
1P0C0E1
1000011
1111 11
